hyp: hrp
jjf: jot wxa blr wkx gkq xpz pna rxt pkh ndd tcd uxc gue ojj grs nhm gsw tgl iip ozl qkv cyr glo
hjz: xgb lvs rbq itw
xvk: kxt omd mcm
ppn: ucq kan
fsw: eqb phn gsi
bgm: ulv nji efj
dpb: fkp ijz
fsz: xrn gtp
ryx: wzz nhb
hej: ngi lgm
ued: tdj zst qxb tyy
htf: brv dzq psn mhg ank rho wwa arf dzf yhd ujc okp zrt
rgw: log
uyy: taj
usu: bwb def pbx gqr
rcc: adj zhn zyy isf
rkf: atb kaf
iwb: ewq
ijz: gpp wjw hmt ryi nxa
pyo: ayg uzh bbx
hwq: nxa hmt ryi
wvt: znv eyt mkq paa
qwm: izk evx
qix: mef
ccm: aqq teu oog
rzo: bsk aal mod dyy log
xvn: ulv nji efj
cgj: xme
fkp: hmt wjw nxa
aqq: cel zlp ycx
mnk: inx wjv
zcs: zae lbi gkt
nhq: aqq teu oog mqw
fjb: srz ilt owa pok stp nhq rpa ecr gqu ccm xom irz jma vcu giy dpo ltm ftp eca dye ocr eln
mtk: qzh dlp yco
erj: afx yig
lbr: kwv oeb swg loy
zrw: xob
gkt: boq
www: fjb uzi vyb
uze: jsh acf htf
hrp: vfo tmu klr zze usu rpe zvh bod ccr guy yjg iwt wvt pbe pwu nno zfy efv zrw gnq
rtf: out
tdj: ivx vyb uzi
vxs: mef jqs mig
vjw: pdz dpv zsl msr
vfo: qqy
cro: hnc pna jiz qoy ojj ndd pkh grs blr wxa
odb: pgk mcj sxn qeu
gxu: gpp hmt
cep: lcz bys cpf
dxn: xmx dce gef
mcm: hyp xen eej bda
kaf: oqq acf htf
dce: tqb
rpa: vyu tvy
irz: aqq teu
ibp: yef lpo vjz
mtw: trj bbx uzh
kwp: dac nsa gdi wjb
gts: upx fft iml bbv
zwg: dlp yco
ews: tef hrp eqg ciu
lnk: wfq oqq jsh htf
qfm: ivx vyb
stf: ogf
hid: jge qsm tkh
jjb: bys ued iya
fnr: wsb
vxy: pwq
yyq: xve gef
ujc: hid
ogf: orq hjj
oog: zlp cel gsd ycx
phn: axe rle fss
ufe: gqe qko cyj rpp
dtd: ddx xrj
xrv: tef eqg iwj
ycp: qix drn
mjs: qeu mcj dne sxn pgk
btn: lbr
xqg: abs pxf
ips: xvn okd
grp: eqb ixy
xrq: gqe qko rpp cyj sfc
ayg: vqe ncf wyw ume
rok: cxj pld lxm
ctf: cyj sfc
rxt: jkg
neo: fft
isr: lwb fxf
may: ycd akw ppn ndv
wjb: rri ica
guy: fvr xob rdk
hhp: mig jqs omk mef
ddc: out
hoq: kwd
mce: pze llf
boq: out
ygr: gjv
qft: pze
vcu: nur aad
psy: out
def: ofa ftk
akw: gnm ucq
lli: fjs dpb
art: mef mig omk
cjh: evz zgg afx
hfq: iku nzf jef vtb iqe
dua: lli rvi mao
rdk: isr die xsm
ocw: gzt may qjt
ouh: you bxs dwp
swg: drn
jef: brc luo
svq: btn hbk gts
dye: neo gts
abs: jqs omk mef
pok: aad nur sib
oqq: hux mhg dzq bxf aue lqi wwa kwp rho ank ujc htc yhd pnw arf zrt yos iwb vbf
zyy: dwp bxs you
gze: vxs kev
aad: ddq
trj: ume vqe
yig: you dwp
rtb: blu iqw mtw oux
rri: bxs
yef: vya xvk
you: xbj fsz zlh eat jsp vgn pei jjt
ove: zhn adj zyy
aue: lnj
zsl: phk rxk ygr gye
qeu: wym vxn aao ews xrv
tmu: byl bwb pbx gqr
hwh: rxr amo ana
mhc: jqs mig mef
mkz: rcc ove dnh
jmd: rxr wha mxu ana
tsq: rfi cxj pld
jot: rmr xfy vur
vej: ebb cik tju
iip: gcx vxy tjg qqx
gsi: yia fss rle
jtm: tkh
vbf: jpf vjw
izk: bgm xvn
tna: lgm vej ngi
eat: rok tsq
qxb: ivx
gqu: tvy
xou: lgm
fsq: ndv ppn
dsa: mcm omd
tsh: uzi ivx vyb
zfy: xob rdk
cao: bru tsh dxd
efv: gqr bwb
gpp: puw
jau: pze wpg
sxn: wym
ccf: gjv
znv: grp ibe
vya: jng omd kxt
sem: ijz fkp hwq
orq: ycy fok rzv
ypb: hrp ciu eqg
xme: cqy
lgm: cik tju hjz
ywo: dce xve fnr xmx
mwf: mkq
hpy: aya pcv att qnj zvv
atb: jsh wfq htf
aeq: fkp
pna: gcx qaz tjg
jkg: fgn kbg dxn yyq
kpb: mqi rcp hoq xsb
kan: igi yrb jmd zgh
kxt: hyp xen bda
nkm: zcs sdg
eal: fjb vyb ivx
sez: mkg
psn: wjb
bsk: vyb ivx fjb
ixy: rle yia
wkx: cep jjb xpr
nji: out
uxc: tjg vxy gcx
xmx: wsb jzk
uzh: ncf wyw fxn vqe
luo: fsy zcs
wnn: out
ofa: oqq acf jsh
ycy: iwj ciu tef hrp
eti: vxs
bvf: lfn gze xmn
rxr: out
ymt: fsq may
xbj: may
cqz: iya lcz cpf bys
ppa: cxj pld lxm rfi
jma: lfn xmn
ftp: ygm swq aad nur
pqp: mgp kaf
ucx: gsi phn
omk: sij whs cux pzv stf jos hej fqt xou tna jva atl pkm
urm: qoq ppb
wfq: dzf yhd pnw htc ujc vbf yos iwb zrt okp lqi brv psn bxf dzq hux ank rho kwp wwa
nxa: uld
tkh: dwp bxs
gjg: rvi
pze: cdh inx kad ryx
bbv: kwv oeb ycp
jva: ngi vej
ngi: ebb hjz
bxf: fts kpb afs ubi
waj: ove dnh hww rcc
qaz: yvk rzo rgw
iqw: uzh
vgn: hys xrn gtp
naa: acf oqq htf
vjz: dsa
npj: jqs
hys: tcj
wsb: ivx vyb
xgb: hrp
fee: you dwp
cqy: rkf oxn pqp
oom: dwp you
pmz: wtg xvu
iku: nkm brc iqx
pgk: vxn wym xrv
vcg: htf acf jsh oqq
vqe: htf
rnx: out
dac: rri ica
loy: qix drn
brc: zcs sdg fsy
pei: rdd mao lli rvi
pzv: vej lgm
pee: srd mvd vjz yef lpo
yos: jpf vjw rib
fft: oeb kwv loy ycp
fss: htf oqq wfq acf jsh
afx: you
jtf: qzh
mlp: iwj
nsa: rri qrt ica
qyr: omk
pkh: kuk
wlo: qyr mbq abs
gsd: lkk
kuk: qnj pcv aya zvv
jpf: goa
zvh: znv eyt xos paa
gye: eak
xrj: out
aya: ivx uzi fjb
dwp: jtf mtk xbj zwg pei ymt eat vgn dua hfq wwr jjt sjg ocw jsp gjg zlh
cik: lvs
bod: xob iew
ebb: lvs xgb rbq fcm itw
arf: hid jtm ewq
nhm: sez
nhb: ciu eqg iwj tef
ryi: udy uld
xpz: hpy
ypz: vyb ivx
igi: rxr wha amo mxu ana
ibe: eqb ixy phn
epe: ddc
nur: ddq
amo: out
eak: dwp you
khn: art zid
mqi: kwd
fkl: omk mef
bxs: dua hfq ymt pei vgn zwg jtf mtk fsz xbj gjg sjg ocw jtk
msr: ccf rxk
ica: you dwp bxs
vyu: mhc
qko: mic ijy cao koy
cyr: yto xrt
lnj: evz afx yig zgg
svr: jjf cro khv pvt
xsb: kwd oom
fdo: jsh acf wfq htf
lvs: hrp tef eqg
lfn: tol
jng: xen hyp eej
hww: zhn adj
ftk: htf wfq jsh acf
ntv: oom fee
bpf: phg lsn oks ift
dop: mff xqg snl wlo
gzt: ppn ndv
jly: dgd xyn jqj
phg: jzs ypz www lus
mkq: ucx fsw ibe grp
zst: ivx uzi fjb
rib: msr pdz dpv
kik: izk ous osl
zae: boq rnx
zgh: ana rxr wha amo
tgl: jjb cqz
rle: oqq acf htf
qjt: ycd ndv ppn akw
dzf: rui
yia: acf jsh
bys: tdj qxb
dxd: fjb
lwb: htf wfq oqq
hmt: udy puw
atl: srd lpo
oux: ayg bbx
zze: xos eyt znv mkq paa
tju: xgb fcm
teu: gsd ycx cel
tjg: pwq rgw rzo
itx: mef omk
gkq: xrq ctf ufe
zvv: fjb uzi
giy: snl mff
rfi: zjx kuv zlt
kev: mig jqs mef
sfc: ijy mic glu
kad: wzz
ddq: jqs mig
ygm: ibz ddq
pld: wsx jly zjx kuv zlt
iya: zst tyy
vqx: pze mnk
srd: dsa xvk vya
glu: dxd tsh qfm
efj: out
gph: afx zgg yig evz
kfa: ppb qoq
gnq: paa xos znv
ank: lzt gph
eej: tef hrp iwj ciu
zlt: dtd xyn dgd
evx: xvn okd
wlt: ppb
wsx: dgd dtd
dne: wym ews aao
gef: wsb jzk
yrb: amo
rlk: you bxs
jzk: uzi fjb ivx
kuv: dgd jqj dtd
rpp: glu ijy mic
qsm: dwp you
lpo: dsa xvk
kbg: fnr
per: lbr iml upx
fcm: eqg
aal: ivx uzi fjb
ucq: igi yrb hwh
iqe: brc luo
axe: htf jsh
khv: ndd pkh qoy tyc wxa gkq wkx jot jiz pna hnc imx ozl iip cyr qkv grs ojj gue gsw nhm doz
tyy: ivx uzi
ivx: irz rpa eln svq gqu ecr kqs dye eca ftp ltm vcu dpo
rdd: aeq sem
ubi: mqi rcp ntv
uzi: ltm giy srz jma pok bvf xom svq
zlh: tsq ppa
pxf: mef
acf: zrt yos vbf pnw wwa rho ank hux dzq psn bxf brv
ijy: tsh
cpf: eal
lkk: jcd zid art
ppb: wdm coj few epe
gjv: you bxs dwp
mtr: mig
ddx: out
bru: fjb vyb
ana: out
qgu: llf wpg
ulv: out
tcd: ctf ufe
xos: ucx ibe
jiz: zuq cep jjb
fxn: acf jsh oqq htf
fqt: wtg xvu
drn: mig
jtk: ppa tsq
iwj: mwf rpe zvh bod zze tmu rtb vfo nno zfy xpj pwu pbe wvt yjg cgj
cwh: bsk mod
bbx: fxn
eca: per
yco: wlt zyn urm kfa
jjt: iku nzf
zpr: xme qqy
xcy: npj
zlp: lkk zyk khn
wjv: mlp nhb
swq: ddq ibz
gqe: koy ijy cao mic glu
bxd: psy rnx boq
mff: qyr pxf mbq
rby: atb mgp
ecm: ivx fjb uzi
xrn: kik
mig: pkm atl ibp fqt xou pmz hej imw cux jos stf pee odb mjs
rrr: mef mig omk
sib: rrr ddq
dlp: urm zyn kfa wlt
mef: sij ibp pkm odb pmz atl
yhd: kpb
gdi: rri
tyc: gcx
hbk: bbv fft upx
paa: ibe ucx
qrt: dwp bxs you
ume: oqq jsh acf
nno: knr uoz wuf
hux: rib vjw jpf
fvr: isr xsm die
fok: eqg iwj ciu hrp
wwr: xrn
dis: rkf pqp rby oxn
zhn: you
yjg: yit knr wuf
pvt: pna glo nhm tgl imx wkx jot iip
oeb: hhp
xpr: cpf bys
imx: ctf xrq
ftg: jzs ecm lus www
oyd: uze lwb ext
eqg: tmu klr vfo rtb aat ccr mwf usu zze bod zvh wvt pbe guy iwt zpr nno gnq zrw
ocr: xcy tvy
qzh: wlt zyn urm
qqy: dis lem cqy fkr
rho: gph erj
tol: omk jqs mig mef
vxn: ciu hrp tef
rzv: tef iwj eqg ciu
jge: dwp
zid: jqs
few: wnn pjv
xve: jzk wsb
pbx: lnk ofa oyb
cel: khn
dpo: xmn gze eti
qnj: uzi vyb
itw: ciu iwj
dgd: xrj ddx
wdm: pjv wnn ddc
ojj: sez xrt yto
lqi: waj
ibz: jqs mef
jcd: mef jqs mig omk
blu: trj bbx uzh
goa: ygr
fhi: ext
ift: ecm www ypz
ycx: zyk khn
fkr: rkf pqp rby
rmr: dxn yyq fgn ywo kbg
qkv: kuk hpy
iew: die xsm oyd fhi isr
jos: qft mce jau
eyt: ibe fsw grp
sij: uyy
ecr: xqg wlo mff ylq
iwt: knr yit
chh: blu oux pyo
dyy: uzi
xfy: yyq dxn ywo
aat: yit uoz
lbk: dis lem fkr
kqs: ygm swq aad
dzq: rui mkz waj
inx: wzz
sdg: bxd lbi zae wbg
ylq: pxf
zjx: xyn jqj
okp: gph erj
jqs: ibp fqt tna xou imw hej pmz pkm jva sij pee whs odb mjs pzv stf jos
wuf: fdo vcg naa bui
srz: tvy vyu
zgg: you dwp bxs
klr: xme qqy
koy: qfm bru tsh
xsm: lwb fxf uze
qoy: sez
grs: jkg xfy rmr
jsp: nzf jef iqe vtb iku
mqw: ycx gsd cel
jqj: rtf
stp: gts btn per
rbu: hwq gxu
oyb: wfq jsh htf
taj: rzv
uld: out
mkg: oks lsn
ggx: oks ift ftg
qqx: rzo cwh rgw yvk pwq
pbe: qqy lbk
llf: inx kad wjv
tqb: uzi fjb ivx
pwq: bsk dyy mod log
rpe: def
ncf: htf acf jsh
xrt: bpf ggx
yit: naa fdo
mhg: ubi afs kpb fts
whs: qft qgu jau mce vqx
bda: iwj ciu hrp
tcj: ips ous osl izk
okd: efj
wjw: udy puw
mic: dxd qfm
zyn: ppb nhw
die: uze lwb
sjg: mao
adj: dwp bxs you
jsh: yhd ujc iwb zrt okp lqi aue mhg psn hux ank rho
pcv: vyb uzi
bwb: oyb
wxa: jjb cqz xpr zuq
ltm: snl xqg mff ylq
wwa: jtm
mcj: wym vxn
glo: jkg xfy rmr
gnm: hwh zgh
gsw: xfy rmr
vtb: nkm iqx brc
log: fjb
fgn: xve xmx fnr dce
yto: ggx mkg bpf
isf: you
osl: bgm xvn okd
lus: fjb vyb ivx
imw: qgu mce
wzz: eqg hrp
mbq: jqs
ilt: swq ygm aad nur
qoq: few
mod: vyb
snl: qyr mtr abs
rcp: ouh fee oom
coj: wnn pjv
mvd: xvk
upx: ycp loy swg kwv
olq: zvv qnj
msk: fok
dpv: phk ccf
mao: aeq sem rbu dpb
fjs: gxu
gue: xrq ufe
pwu: pyo
ndv: ucq gnm
ous: okd bgm
ext: jsh wfq oqq
fsy: bxd gkt lbi wbg
ndd: hpy
pnw: nsa dac wjb gdi
wtg: msk orq
iqx: sdg
phk: eak gjv enw
brv: gdi
zyk: zid jcd
wha: out
vyb: dop owa eca dpo vcu srz ccm exx jma abh nhq ocr dye kqs stp
xpj: iew fvr
ccr: gqr def bwb byl
hnc: ufe xrq
ozl: qqx vxy
kwd: bxs you
ciu: zrw zfy nno pwu xpj pbe guy yjg ccr rpe rtb vfo gnq efv zpr wvt iwt cgj mwf chh aat bod zvh usu klr tmu
tvy: mhc itx npj
lbi: rnx psy
exx: mff ylq xqg wlo
gqr: ofa oyb
ewq: jge tkh qsm rlk
lzt: afx yig evz
xyn: xrj ddx
cyj: glu mic koy cao
wbg: rnx
htc: cjh
zuq: lcz ued bys
cdh: mlp nhb wzz
owa: tvy xcy vyu
nhw: few coj
cux: dne sxn mcj
doz: xpr cqz
puw: out
kwv: qix
uoz: naa vcg fdo
eqb: rle axe yia
knr: bui fdo
fts: mqi rcp ntv hoq xsb
pdz: gye phk ccf rxk ygr
lcz: qxb zst eal
lxm: zlt zjx
xen: iwj ciu tef hrp
omd: ypb
fxf: oqq htf
mxu: out
byl: lnk ofa oyb ftk
tef: nno zpr xpj pwu wvt iwt yjg cgj ccr chh aat usu tmu
bui: acf jsh wfq
gtp: kik tcj qwm
yvk: aal
pjv: out
dnh: isf
lsn: jzs ecm lus www ypz
xmn: kev tol fkl
att: ivx
iml: kwv swg loy ycp
oxn: kaf
vur: yyq ywo
jzs: fjb uzi ivx vyb
abh: eti xmn
blr: kuk olq hpy
evz: you bxs dwp
afs: hoq rcp ntv mqi
eln: per hbk
zrt: jpf
rvi: rbu fjs
tyl: rzv
aao: tef ciu iwj
udy: out
rui: hww rcc
xvu: taj tyl msk orq
wym: hrp tef iwj eqg
hjj: ycy fok
gcx: yvk rgw cwh
wyw: jsh oqq wfq
rxk: eak enw
xob: isr fhi die oyd xsm
nzf: luo
oks: ecm jzs www lus
mgp: wfq oqq acf jsh
rbq: hrp tef eqg iwj
xom: gze xmn eti
pkm: mcj dne
ycd: ucq kan
lem: rby oxn
enw: bxs
cxj: wsx zjx zlt kuv
wpg: cdh kad ryx wjv
